###########
#       # #
# ##### # #
# #     # #
# ####### #
#   #     #
### ##### #
#   #   # #
# ### # # #
#     #   #
###########
